{
  "Author": "Florian",
  "Lines": 10,
  "Columns": 9,
  "Map": [
    [ 0, 0, 0, 0, 0, 0, 0, 0, 0 ],
    [ 0, 0, 0, 0, 0, 0, 0, 0, 0 ],
    [ 3, 3, 3, 3, 3, 3, 3, 3, 3 ],
    [ 2, 2, 2, 2, 2, 2, 2, 2, 2 ],
    [ 1, 1, 1, 1, 1, 1, 1, 1, 1 ],
    [ 0, 0, 0, 0, 0, 0, 0, 0, 0 ],
    [ 0, 0, 0, 0, 0, 0, 0, 0, 0 ],
    [ 0, 0, 0, 0, 0, 0, 0, 0, 0 ],
    [ 0, 0, 0, 0, 0, 0, 0, 0, 0 ],
    [ 0, 0, 0, 0, 0, 0, 0, 0, 0 ]

  ]
}